var world = {
        map: {"2": [0, 0, 0, 0, 0, 0, 0, 0, 0, 0, 0, 0, 0, 0, 0, 0, 0, 0, 0, 0, 0, 0, 0, 0, 0, 0, 0, 0, 0, 0, 0, 0, 0, 0, 0, 0, 0, 0, 0, 0, 0, 0, 0, 0, 0, 0, 0, 0, 0, 0, 0, 0, 0, 0, 0, 0, 0, 0, 0, 0, 0, 0, 0, 0, 0, 0, 0, 0, 0, 0, 0, 0, 0, 0, 0, 0, 0, 0, 0, 0, 0, 0, 0, 0, 0, 0, 0, 0, 0, 0, 0, 0, 0, 0, 0, 0, 0, 0, 0, 0, 0, 0, 10, 10, 10, 10, 10, 10, 10, 10, 10, 10, 10, 10, 10, 10, 10, 10, 10, 10, 10, 10, 10, 10, 10, 10, 0, 0, 0, 0, 0, 0, 0, 0, 10, 10, 10, 10, 10, 10, 10, 10, 10, 10, 10, 10, 10, 10, 10, 10, 10, 10, 10, 10, 10, 10, 10, 10, 0, 0, 0, 0, 0, 0, 0, 0, 10, 0, 0, 0, 0, 0, 10, 0, 0, 0, 0, 0, 0, 0, 0, 10, 0, 0, 0, 0, 0, 0, 0, 10, 0, 0, 0, 0, 0, 0, 0, 0, 0, 0, 0, 0, 0, 0, 10, 0, 0, 0, 0, 0, 0, 0, 0, 10, 0, 0, 0, 0, 0, 0, 0, 0, 0, 0, 0, 0, 0, 0, 0, 0, 0, 0, 0, 0, 0, 0, 0, 0, 0, 0, 0, 0, 0, 0, 0, 0, 0, 0, 0, 0, 0, 0, 0, 0, 0, 0, 0, 0, 0, 0, 0, 0, 10, 0, 0, 0, 0, 0, 0, 0, 0, 0, 0, 0, 0, 0, 0, 0, 0, 0, 0, 0, 0, 0, 0, 10, 0, 0, 0, 0, 0, 0, 0, 0, 10, 10, 0, 0, 0, 10, 10, 10, 10, 10, 10, 10, 10, 10, 10, 10, 10, 10, 10, 10, 10, 10, 10, 10, 0, 0, 0, 0, 0, 0, 0, 0, 10, 0, 0, 0, 10, 10, 10, 10, 10, 10, 10, 10, 10, 10, 10, 10, 10, 10, 10, 10, 10, 10, 10, 10, 0, 0, '0', 0, 0, 0, 0, 0, 10, 0, 0, 10, 10, 10, 10, 10, 10, 10, 10, 10, 10, 10, 10, 10, 10, 10, 10, 10, 10, 10, 10, 10, 0, 0, 0, 0, 0, 0, 0, 0, 10, 10, 0, 0, 0, 0, 0, 0, 0, 0, 0, 10, 0, 0, 0, 0, 0, 0, 10, 0, 0, 0, 0, 10, 0, 0, 0, 0, 0, 0, 0, 0, 10, 10, 10, 0, 0, 0, 0, 0, 0, 0, 0, 10, 0, 0, 0, 0, 0, 0, 10, 0, 0, 0, 0, 10, 0, 0, 0, 0, 0, 0, 0, 0, 10, 10, 10, 10, 0, 0, 0, 0, 0, 0, 0, 10, 0, 0, 0, 0, 0, 0, 10, 0, 0, 0, 0, 0, 0, 0, 0, 0, 0, 0, 0, 0, 10, 10, 10, 10, 10, 0, 0, 0, 0, 0, 0, 0, 0, 0, 0, 0, 0, 0, 0, 0, 0, 0, 0, 0, 0, 0, 0, 0, 0, 0, 0, 0, 10, 10, 10, 10, 10, 10, 0, 0, 0, 0, 0, 0, 0, 0, 0, 0, 0, 0, 0, 0, 0, 0, 0, 10, 0, 0, 0, 0, 0, 0, 0, 0, 10, 10, 10, 10, 10, 10, 10, 10, 10, 10, 10, 10, 10, 10, 10, 10, 10, 10, 10, 10, 10, 10, 8, 10, 0, 0, 0, 0, 0, 0, 0, 0, 10, 10, 10, 10, 10, 10, 10, 10, 10, 10, 10, 10, 10, 10, 10, 10, 10, 10, 10, 10, 10, 0, 8, 10, 0, 0, 0, 0, 0, 0, 0, 0, 10, 10, 10, 10, 10, 10, 10, 10, 10, 10, 10, 10, 10, 10, 10, 10, 10, 10, 10, 10, 10, 0, 8, 10, 0, 0, 0, 0, 0, 0, 0, 0, 10, 0, 0, 0, 0, 0, 0, 0, 0, 0, 0, 10, 0, 0, 0, 0, 0, 0, 0, 0, 10, 0, 8, 10, 0, 0, 0, 0, 0, 0, 0, 0, 10, 0, 0, 0, 0, 0, 0, 0, 0, 0, 0, 10, 0, 0, 0, 0, 0, 0, 0, 0, 10, 0, 8, 10, 0, 0, 0, 0, 0, 0, 0, 0, 0, 0, 0, 0, 0, 0, 0, 0, 0, 0, 0, 0, 0, 0, 0, 0, 0, 0, 0, 0, 10, 0, 8, 10, 0, 0, 0, 0, 0, 0, 0, 0, 0, 0, 0, 0, 0, 0, 0, 0, 0, 0, 0, 0, 0, 0, 0, 0, 0, 0, 0, 0, 0, 0, 8, 10, 0, 0, 0, 0, 0, 0, 0, 0, 0, 0, 0, 0, 0, 0, 0, 0, 0, 0, 0, 0, 0, 0, 0, 0, 0, 0, 0, 0, 0, 0, 8, 10, 0, 0, 10, 10, 10, 10, 10, 10, 10, 10, 10, 10, 10, 10, 10, 10, 10, 10, 10, 10, 10, 10, 10, 10, 10, 0, 0, 0, 10, 10, 10, 10, 10, 10, 10, 10, 10, 10, 10, 10, 10, 10, 10, 10, 10, 10, 10, 10, 10, 10, 10, 10, 10, 10, 10, 10, 0, 0, 0, 10, 10, 10, 10, 10, 10, 10, 10, 10, 10, 10, 10, 10, 10, 0, 0, 0, 0, 0, 0, 0, 0, 0, 0, 0, 0, 0, 0, 0, 0, 0, 10, 10, 10, 10, 10, 10, 10, 10, 10, 10, 10, 10, 10, 10, 10, 0, 0, 0, 0, 0, 0, 0, 0, 0, 0, 0, 'X', 0, 0, 0, 0, 10, 10, 10, 10, 10, 10, 10, 10, 10, 10, 10, 10, 10, 10, 10, 10, 0, 0, 0, 0, 0, 0, 0, 0, 0, 0, 0, 0, 0, 0, 0, 10, 10, 10, 10, 10, 10, 10, 10, 10, 10, 10, 10, 10, 10, 10, 10, 10, 0, 0, 0, 0, 0, 0, 0, 0, 0, 0, 0, 0, 0, 0, 10, 10, 10, 10, 10, 10, 10, 10, 10, 10, 10, 10, 10, 10, 10, 10, 10, 10, 10, 10, 10, 10, 10, 10, 10, 10, 10, 10, 10, 10, 10, 10, 10, 10, 10, 10, 10, 10, 10, 10, 10, 10, 10],

        "3":[
        [0,0,0,0,0,0,0,0,0,0],
        [0,0,0,0,0,0,0,0,0,0],
        [0,0,0,0,0,0,0,0,0,0],
        [0,0,0,0,0,0,0,1,0,0],
        [0,0,0,0,0,0,0,0,0,0],
        [0,0,0,0,0,0,0,0,0,0],
        [0,0,0,0,0,0,0,0,0,0],
        [0,0,0,0,0,0,0,0,0,0],
        [0,0,0,0,0,0,0,0,0,0],
        [0,0,0,0,0,0,0,0,0,0],
        [0,0,0,0,0,0,0,0,0,0],
        [0,0,0,0,0,0,0,0,0,0],
        [0,0,0,0,0,0,0,0,0,0],
        [0,0,0,0,0,0,0,0,0,0],
        [0,0,0,0,0,0,0,0,0,0],
        [0,0,0,0,0,0,0,0,0,0],
        [0,0,0,0,0,0,0,0,0,0],
        [0,0,0,0,0,0,0,0,0,0],
        [0,0,0,0,0,0,0,0,0,0],
        [0,0,0,0,0,0,0,0,0,0],
        [0,0,0,0,0,0,0,2,0,0],
        [0,0,0,0,0,0,0,1,0,0],
        [0,0,0,0,1,0,0,0,0,0],
        [0,0,0,0,0,0,0,0,0,0],
        [0,0,0,0,0,0,0,1,0,0],
        [0,0,0,0,0,0,0,0,0,0],
        [0,0,0,0,0,2,0,0,0,0],
        [0,0,0,0,0,0,0,0,0,0],
        [0,0,0,0,0,0,0,0,0,0],
        [0,0,0,0,0,0,0,3,0,0],
        [0,0,0,0,0,0,0,0,0,0],
        [0,0,0,0,0,0,0,0,0,0]]},

        trigger: [
        [0,0,0,0,0,0,0,0,0,0],
        [0,0,0,0,0,0,0,0,0,0],
        [0,0,0,0,0,0,0,0,0,0],
        [0,0,0,0,0,0,0,0,0,0],
        [0,0,0,0,0,0,0,0,0,0],
        [0,0,0,0,0,0,0,0,0,0],
        [0,0,0,0,0,0,0,0,0,0],
        [0,0,0,0,0,0,0,0,0,0],
        [0,0,0,0,0,0,0,0,0,0],
        [0,0,0,0,0,0,0,0,0,0],
        [0,0,0,0,0,0,0,0,0,0],
        [0,0,0,0,0,0,0,0,0,0],
        [0,0,0,0,0,0,0,0,0,0],
        [0,0,0,0,0,0,0,0,0,0],
        [0,0,0,0,0,0,0,0,0,0],
        [0,0,0,0,0,0,0,0,0,0],
        [0,0,0,0,0,0,0,0,0,0],
        [0,0,0,0,0,0,0,0,0,0],
        [0,0,0,0,0,0,0,0,0,0],
        [0,0,0,0,0,0,0,0,0,0],
        [0,0,0,0,0,0,0,0,0,0],
        [0,0,0,0,0,0,0,0,0,0],
        [0,0,0,0,0,0,0,0,0,0],
        [0,0,0,0,0,0,0,0,0,0],
        [0,0,0,0,0,0,0,0,0,0],
        [0,0,0,0,0,0,0,0,0,0],
        [0,0,0,0,0,0,0,0,0,0],
        [0,0,0,0,0,0,0,0,0,0],
        [0,0,2,0,0,0,0,0,0,0],
        [0,0,0,0,0,0,0,0,0,0],
        [0,0,0,0,0,0,0,0,0,0],
        [0,0,0,0,0,0,0,0,0,0]]
};

var rooms = {
        "2":{map: [
        [9,9,9,8,9,9,9,8,9,9],
        [9,0,0,0,9,0,0,0,9,9],
        [9,0,0,0,9,0,0,0,9,9],
        [9,0,0,0,9,0,0,0,9,9],
        [9,0,0,0,9,0,0,0,9,9],
        [9,0,0,0,9,0,0,0,9,9],
        [9,9,0,0,9,0,0,0,9,9],
        [9,0,0,0,9,0,0,0,9,9],
        [9,0,0,0,9,9,9,0,9,9],
        [9,0,0,0,9,0,0,0,9,9],
        [9,0,0,0,9,0,0,0,9,9],
        [9,0,0,0,9,0,0,0,9,9],
        [9,0,0,0,9,9,9,0,9,9],
        [9,0,0,0,9,0,0,0,9,9],
        [9,9,0,0,9,0,0,0,9,9],
        [9,0,0,0,9,0,0,0,9,9],
        [9,0,0,0,7,7,7,7,7,9],
        [9,0,0,0,9,0,0,0,9,9],
        [9,0,0,0,9,0,0,0,9,9],
        [9,9,9,9,9,9,9,9,9,9]],
        trigger: [
        [0,0,0,3,0,0,0,'W',0,0],
        [0,0,0,0,0,0,0,0,0,0],
        [0,0,0,0,0,0,0,0,0,0],
        [0,0,0,0,0,0,0,0,0,0],
        [0,0,0,0,0,0,0,0,0,0],
        [0,0,0,0,0,0,0,0,0,0],
        [0,0,0,0,0,0,0,0,0,0],
        [0,0,0,0,0,0,0,0,0,0],
        [0,0,0,0,0,0,0,0,0,0],
        [0,0,0,0,0,0,0,0,0,0],
        [0,0,0,0,0,0,0,0,0,0],
        [0,0,0,0,0,0,0,0,0,0],
        [0,0,0,0,0,0,0,0,0,0],
        [0,0,0,0,0,0,0,0,0,0],
        [0,0,0,0,0,0,0,0,0,0],
        [0,0,0,0,0,0,0,0,0,0],
        [0,0,0,0,0,0,0,0,0,0],
        [0,0,0,0,0,0,0,0,0,0],
        [0,0,0,0,0,0,0,0,0,0],
        [0,0,0,0,0,0,0,0,0,0]]
        },

        "3":{map: [
        [9,9,9,9,9,9,9,8,9,9],
        [9,0,0,0,0,0,0,0,9,9],
        [9,0,0,0,0,0,0,0,9,9],
        [9,0,0,0,0,0,0,0,9,9],
        [9,0,0,0,0,0,0,0,9,9],
        [9,0,0,0,0,0,0,0,9,9],
        [9,0,0,0,0,0,0,0,9,9],
        [9,0,0,0,0,0,0,0,9,9],
        [9,0,0,0,0,0,0,0,9,9],
        [9,0,0,0,0,0,0,0,9,9],
        [9,0,0,0,0,0,0,0,9,9],
        [9,0,0,0,0,0,0,0,9,9],
        [9,0,0,0,0,0,0,0,9,9],
        [9,9,9,9,9,9,9,0,9,9],
        [9,0,0,0,9,0,0,0,9,9],
        [9,0,0,0,9,0,0,0,9,9],
        [9,0,0,0,7,7,7,7,9,9],
        [9,0,0,0,9,0,0,0,9,9],
        [9,0,0,0,9,0,0,0,9,9],
        [9,9,9,9,9,9,9,9,9,9]], 
        trigger: [
        [0,0,0,0,0,0,0,2,0,0],
        [0,0,0,0,0,0,0,0,0,0],
        [0,0,0,0,0,0,0,0,0,0],
        [0,0,0,0,0,0,0,0,0,0],
        [0,0,0,0,0,0,0,0,0,0],
        [0,0,0,0,0,0,0,0,0,0],
        [0,0,0,0,0,0,0,0,0,0],
        [0,0,0,0,0,0,0,0,0,0],
        [0,0,0,0,0,0,0,0,0,0],
        [0,0,0,0,0,0,0,0,0,0],
        [0,0,0,0,0,0,0,0,0,0],
        [0,0,0,0,0,0,0,0,0,0],
        [0,0,0,0,0,0,0,0,0,0],
        [0,0,0,0,0,0,0,0,0,0],
        [0,0,0,0,0,0,0,0,0,0],
        [0,0,0,0,0,0,0,0,0,0],
        [0,0,0,0,0,0,0,0,0,0],
        [0,0,0,0,0,0,0,0,0,0],
        [0,0,0,0,0,0,0,0,0,0],
        [0,0,0,0,0,0,0,0,0,0]]
        },
};

var connections = {};
connections["world"] = [
    {ID: "2", x: 28, y: 2, startX: 250, startY: 242, xScroll: -215, yScroll: -8}
];

connections["2"] = [
    {ID: "world", x: 0, y: 7}, 
    {ID: "3", x: 0, y: 3, startX: 250, startY: 242, xScroll: -222, yScroll: -8}
];

connections["3"] = [
    {ID: "2", x: 0, y: 7, startX: 250, startY: 178, xScroll: -222, yScroll: -72}
];

